8
P 0 0 B B 0 0 0
0 0 B 0 0 B 0 0
0 0 0 0 0 0 0 0
B 0 S 0 0 S 0 B
B 0 S 0 0 S 0 B
0 0 0 0 0 0 0 0
0 0 B 0 0 B 0 0
0 0 0 B B 0 0 0
